########################
#......................#
#......................#
#.........####.........#
#......................#
#......................#
#......######..........#
#......................#
#............P.........#
########################
